
   
NO ./textures/bluestone.xpm        
SO ./textures/colorstone.xpm       
	WE ./textures/greystone.xpm      		  	       
     
R		 400 300

    			EA 								./textures/redbrick.xpm
					S 				./textures/barrel.xpm


F 117, 142 , 79     
C 135 ,    245 , 251         

111111111111
100000000001
111100010001
1000001	10001
100N00010001
100000100201
102000100001
111111111111















